3 3
0 0 17 0 0 2 0 0 2
0 0 5 0 0 1 0 0 1
0 0 5 0 0 1 0 0 1
0 1 2 0 1 2 0 1 2
0 1 1 0 1 1 0 1 1
0 1 1 0 1 1 0 1 1
0 2 2 0 2 2 0 2 18
0 2 1 0 2 1 0 2 3
0 2 1 0 2 1 0 2 3
0 0 5 0 0 1 0 0 1
0 0 5 0 0 1 0 0 1
0 0 5 0 0 1 0 0 1
0 1 1 0 1 1 0 1 1
0 1 1 0 1 1 0 1 1
0 1 1 0 1 1 0 1 1
0 2 1 0 2 1 0 2 3
0 2 1 0 2 1 0 2 3
0 2 1 0 2 1 0 2 3
0 0 5 0 0 1 0 0 1
0 0 5 0 0 1 0 0 1
0 0 16 0 0 4 0 0 4
0 1 1 0 1 1 0 1 1
0 1 1 0 1 1 0 1 1
0 1 4 0 1 4 0 1 4
0 2 1 0 2 1 0 2 3
0 2 1 0 2 1 0 2 3
0 2 4 0 2 4 0 2 19